######
#1...#
##.#.#
#..#.#
##.###
#...2#
######
